7 10
__________
oooooooooo
o____o____
o____o____
_o__o_____
__oo______
___o______